############################################
##                        ##              ##
#                         #                #
#     ##                             ####  #
#      #          #                        #
#                ###        ## ##          #
#                 #         ## ##          #
#                                   ##     #
##         #                         ##    #
###        ##                 #       ##   #
#                         #                #
#                         #                #
#                     ##               #   #
#                     #                    #
#    ###            #          #####       #
#    ###          ##          #####        #
#    ###         ###         ##           ##
##              ####        ##            ##
####                       ##            ###
########                         ##    #####
############################################