##############################
#####   #   ####      #  #####
###          ##   S        ###
##                          ##
#                            #
#     B                     ##
#               ###          #
##             ###          ##
###      ##    ##    F     ###
#####   ###              #####
##############################